###########
#        C#
#         #
#         #
#         #
#   S     #
####D######