###################
#               #E#
# ############ ## #
#            #    #
########## ########
#                 #
################# #
#     #         # #
# ##### ### # # # #
#     # # # # # # #
# ### # # # # # # #
# # # # # # # # # #
# # # # # # # ### #
#S  #   #   #     #
###################